xxxxxxxxxxxxxxxxxxxxxxx
x                     x
x 2  1                x
x                     x
xxxx                  x
x                     x
x                     x
x                     x
x     o               x
xxxxxxxxxxxxxxxxxxxxxxx