xxxxxxxxxxxxxxxxxxxxxxx
x                     x
x                     x
x                     x
x                     x
x2                    x
x1    o               x
xxxxxxxxxxxxxxxxxxxxxxx